voice-over	experience
video	henry
software	capacity
gender	method
e-mail	artist
teaspoon	element
feedback	academy
lifestyle	alliance
youre	chorus
metro	theme
database	utility
website	velvet
pasta	rider
tablespoon	controversy
update	flour
workplace	archbishop
healthcare	uncertainty
fax	spy
workout	resident
regression	resentment
parenting	moisture
ethnicity	fortnight
baseline	brigade
ecosystem	dialogue
processor	treasurer
ppg	rue
spokeswoman	fascination
icon	ivory
globalization	recommendation
email	meadow
governance	dictionary
interface	inventor
workforce	velocity
laptop	goose
biodiversity	individuality
info	bin
blog	grape
outreach	chronicle
preschool	particle
privatization	justification
overview	secession
watercolor	fertility
backpack	premium
download	enactment
artwork	ransom
hip-hop	sultan
peacekeeping	disappearance
salsa	bias
same-sex	destroyer
multimedia	prediction
genome	pudding
predictor	collision
autism	scalp
sensor	truce
cilantro	arrogance
sustainability	consolidation
empowerment	substitution
condom	canton
self-efficacy	co-operation
ethanol	trader
anthrax	mortar
tsunami	volcano
rehab	yore
filmmaker	endowment
subscale	magnetism
def	se
entitlement	retaliation
tsp	dye
condo	coil
bailout	wizard
groundwater	ratification
downside	induction
landfill	formality
algorithm	charcoal
wastewater	plaintiff
spokesperson	penitentiary
postseason	nightfall
dysfunction	disclosure
sitcom	strand
analog	flute
tofu	nun
arousal	pallor
ballpark	pyramid
victimization	self-control
backcountry	contingency
offseason	magician
burnout	tremor
biomass	equator
acculturation	sitting-room
osteoporosis	conservatory
start-up	thinker
fundraising	antagonism
firefighter	aspiration
homelessness	adjournment
testosterone	cleanliness
biotechnology	statesmanship
caregiver	embodiment
browser	trophy
nonstick	foothold
cornerback	homestead
sunscreen	hardness
biotech	tablet
cellphone	panorama
soundtrack	grievance
wellness	infinity
cyberspace	parsonage
makeover	sulphur
app	mi
steroid	contour
ponytail	orthodoxy
after-school	incarnation
sushi	foil
oregano	missus
meltdown	plurality
gridlock	subtlety
template	derrick
worldview	mulberry
rapper	anthem
fund-raiser	advertiser
giftedness	occupancy
multiculturalism	constitutionality
pandemic	viceroy
audiotape	turnpike
timeline	hostage
handheld	parapet
telecom	jargon
epidemiology	specification
ultrasound	progression
mpg	beak
self-report	ingredient
wake-up	palate
marinade	nearness
matchup	jingle
self-concept	undergrowth
minivan	potency
hotline	mishap
aerobics	extortion
subset	envoy
pretest	potash
vibe	ist
wetland	mistrust
sexism	spice
remediation	credibility
whos	chili
mindset	parable
bandwidth	subversion
vegan	rarity
coauthor	atheist
antioxidant	inflammation
deforestation	self-reliance
mozzarella	accessory
pesto	socket
biosphere	defection
pts	ch
startup	exponent
replication	rattlesnake
prosthesis	whirlpool
fundraiser	flirtation
chi-square	purgatory
postmodernism	constellation
arugula	kernel
aquaculture	theologian
rainforest	repulsion
cardio	pallet
mind-set	algebra
percentile	allegation
taxonomy	openness
trailhead	durability
dumpster	decanter
cyber	boar
caregiving	misdemeanor
carcinoma	legitimacy
ricotta	liturgy
methamphetamine	demoralization
payback	ostrich
subgroup	scuffle
facilitator	chronology
daycare	burrow
dot-com	manger
predation	rhinoceros
canola	heron
moisturizer	favoritism
weight-loss	forerunner
coursework	betrothal
spreadsheet	guillotine
midlife	travail
couscous	renegade
nanotechnology	subject-matter
homophobia	astrologer
inpatient	storehouse
pathogen	cobbler
optimization	condensation
poetics	crutch
aka	cf
risotto	blister
functionality	truthfulness
epicenter	gymnastics
finalist	seduction
dopamine	paymaster
encryption	connoisseur
practicum	sediment
e-commerce	grasshopper
test-retest	dissection
subtest	newness
connector	reprimand
meta-analysis	hallucination
lasagna	striker
lambda	clove
pixel	wasn
blogger	raisin
hyperactivity	starting-point
neuroscience	fabrication
karaoke	camphor
steelhead	cannibal
veggie	probate
connectivity	honeysuckle
free-agent	instalment
camcorder	smuggler
self-worth	hesitancy
derailleur	wonderment
tinnitus	javelin
jalapeno	trumpeter
firestorm	mackerel
chemo	girth
countertop	camp-fire
aquifer	seeker
workstation	pacification
no-fly	gloss
discriminant	hopefulness
upfront	caliph
detainee	theorist
lymphoma	subsoil
superhero	cerebellum
low-sodium	indorsement
hypothermia	unpopularity
synergy	encore
no-brainer	down-stairs
airfare	lullaby
forensics	sulphate
subtext	scurvy
kayaking	mermaid
apnea	emir
coworker	zoology
largemouth	wheelwright
gamma-ray	divination
stressor	gridiron
tomography	punctuation
pager	caro
oncology	bailiff
motivator	journeyman
stakeholder	retrenchment
co-chair	genealogy
firewall	compost
snowboard	regulator
drywall	breech
downtime	godmother
affordability	impersonation
cappuccino	inoculation
renewables	uselessness
reinvention	definiteness
childcare	canister
texting	mimicry
ultralight	sociability
moniker	bleach
pulsar	caper
antidepressant	sub-committee
fine-tuning	merchantmen
wild-card	mainsail
t-test	mogul
latte	spec
salience	skeptic
antivirus	touchstone
genomics	terrapin
shallot	angler
biodiesel	autocrat
malware	surname
oncologist	substratum
bioethics	smattering
melatonin	marksman
add-on	archery
triathlon	confidante
chalkboard	men-of-war
playbook	redness
biota	basalt
sobre	thong
telemarketing	physiologist
deep-sky	lexicon
lube	hee
metadata	essayist
baguette	serfdom
keyword	hatter
hydration	helmsman
otitis	snipe
tamoxifen	apotheosis
nano	hasn
cortisol	porpoise
ibuprofen	mainspring
bulimia	lunacy
transducer	broomstick
pedophile	ill-health
blogging	granary
subsystem	schoolmate
e-book	foray
joystick	noblesse
eyeliner	dispenser
ecclesiology	antechamber
cell-phone	commutation
timeout	lioness
clubhead	hatchway
covariate	coxswain
seafloor	furlong
tradeoff	predicate
overfishing	revocation
osteoarthritis	excommunication
spyware	oddity
miso	thyme
personhood	pawnbroker
covariance	bluntness
burrito	idiocy
anti-terrorism	sentimentalist
glam	shire
clubface	saunter
bioterrorism	tete-a-tete
cookware	wellbeing
outage	gypsum
bycatch	siesta
redshirt	chattel
guacamole	abrogation
bottom-up	cocoanut
oxymoron	surfeit
near-death	tambourine
ex-boyfriend	half-brother
weightlifting	smoking-room
stem-cell	steersman
quinoa	curio
keypad	corolla
self-care	fastness
folate	guano
narratology	merchantman
rollover	ferryman
ex-girlfriend	domestication
gangsta	trefoil
phyllo	mille
homecare	butternut
telecommuting	story-telling
metastasis	parallelism
hardcopy	horoscope
bungee	skein
partial-birth	sentimentalism
techno	thorax
jihadist	swordsman
conferencing	childishness
detox	alum
collider	hostelry
shoulder-width	convertibility
biofeedback	leave-taking
chainsaw	colonist
worksheet	ostracism
grunge	ochre
shiitake	neuralgia
halogen	amulet
concealer	banisters
redshift	turnkey
futon	marl
byte	ane
pancetta	schafft
winemaker	exactitude
seatpost	alluvium
single-payer	semi-circle
pre-test	doubloon
copycat	cohort
interrater	worshiper
signage	icicle
collegiality	window-seat
hummus	frill
celeb	deux
smartphone	heliotrope
tempeh	pincers
bulgur	antic
self-perception	re-establishment
menorah	akimbo
yellowfin	carbuncle
mimesis	joiner
fossa	coffer
neuroscientist	stepping-stone
marinara	sobriquet
hijab	petrel
goalkeeper	nonentity
weeknight	feldspar
wormhole	albumen
feedstock	exhalation
longline	wouldnt
single-sex	peroration
uptick	garde
paralegal	one-horse
factorial	repeller
headlamp	lossing
aromatherapy	adulteration
nonattainment	misadventure
lycopene	ignoramus
off-the-shelf	idiosyncrasy
focuser	patois
subsample	centipede
focalization	resuscitation
ethicist	pickerel
droid	suet
decaf	pupa
germplasm	denudation
night-vision	reanimation
roadmap	wanter
returner	tourney
podcast	shaver
vez	ele
storyline	distillery
chorizo	theism
seatbelt	exegesis
transboundary	meetinghouse
mindfulness	defamation
peptide	truism
toolbar	jerkin
wasabi	myrrh
e-books	bassoon
midrange	gizzard
hairstylist	incoherence
rollout	sutler
low-intensity	retrogression
mixed-use	giddiness
motherboard	neckerchief
perfusion	gelatine
takeaway	equinox
radicchio	shot-gun
wideout	madcap
contrarian	slenderness
out-of-wedlock	tortoise-shell
sunblock	ambrosia
low-dose	schemer
ergonomics	witticism
lemongrass	life-work
camo	acta
quartile	solstice
tendinitis	curmudgeon
desde	signer
roadie	whelp
varimax	plantain
biofuel	finisher
webcam	auger
contestation	peacefulness
seagrass	dumpling
right-click	receivable
drawdown	manikin
orienteering	parishioner
aftermarket	wastefulness
cultivar	suasion
tilapia	phantasy
skinhead	sky-line
frontman	onehalf
at-bat	charg
bifida	sedge
endometriosis	hypochondriac
fettuccine	note-books
allele	relict
hatchback	monotheism
bodybuilding	investiture
musics	earldom
soft-tissue	obtuseness
wiki	ani
carpool	parvenu
ulama	meme
self-promotion	intellectuality
winemaking	disavowal
scallion	deadness
understory	music-room
lutein	croup
remix	lege
fibromyalgia	interregnum
arrhythmia	alchemist
handover	jewellery
inbox	cava
reboot	dorme
lithium-ion	hocus-pocus
fatwa	wort
workfare	arrowroot
dial-up	toiler
voicemail	falseness
non-district	interpolation
burqa	baize
student-teacher	suggestiveness
adobo	hussar
chiasmus	cormorant
nachos	pewee
endoscopy	bay-window
dataset	haunch
polymerase	twentyone
high-efficiency	utilitarianism
comorbidity	expressman
prion	gusset
koi	fil
geoengineering	speech-making
timeframe	pleurisy
frizz	blin
megawatt	huckster
synch	apiary
jaw-dropping	combativeness
off-trail	pincushion
bridewealth	abnegation
poblano	pugilist
bluefin	hawser
gelato	shammy
hip-width	perfumery
speakerphone	massiveness
on-task	fennel
biopic	rower
essentialist	farthingale
emirate	plinth
avoidant	bowstring
carpal	joist
head-to-toe	continence
fascia	warnin
toolkit	findin
two-factor	proclivity
creatinine	briskness
bowhunting	speciality
impulsivity	preemption
sociopath	tableland
brulee	praetor
obra	ori
stormwater	struction
hoisin	vesicle
confit	triplet
nanosecond	steepness
sunroof	basswood
hoodie	nitre
conflation	door-knob
bodybuilder	fox-hunting
rebar	lugger
duvet	dray
victimhood	skull-cap
cada	zur
ischemia	gentian
globalism	foulness
sockeye	ascidian
interleague	love-story
estaba	stockin
soymilk	windvane
narrativity	country-side
hagfish	lock-up
wakeup	naida
buy-in	sirup
neuropathy	fallibility
drop-offs	story-book
crankset	profitt
airbag	pillion
reticle	lonley
telomerase	ill-temper
bronzer	demijohn
surrogacy	gold-dust
birthweight	bibliomaniac
mentorship	distiller
hantavirus	twentytwo
turn-on	cussin
porcini	leafage
representativeness	self-justification
faceup	amore
voice-mail	escritoire
antiterrorism	shiftlessness
screener	fly-leaf
suppl	sprain
linearity	nimbleness
polycarbonate	self-delusion
drow	tra
subtype	splice
biofilter	endpaper
antilock	horse-car
inculturation	double-dealing
sportfishing	hairbreadth
otorrhea	mattock
superstore	ponderable
role-play	entomology
hotspot	maggot
sonogram	fatalist
biometrics	cook-house
consultee	bath-tub
subcategory	mamillaria
leachate	ecliptic
ppb	ld
underrepresentation	straightforwardness
encoder	claxon
leptin	ilium
masala	sancta
self-presentation	maladministration
stockpot	glazier
low-fare	guillemot
dysplasia	overpass
waveform	snuffbox
nematode	peristyle
qubit	alle
stepdad	banyan
flyfishing	conjugation
self-referencing	conventionalism
peer-to-peer	conservator
quintile	artiste
identifier	appellant
dorsiflexion	dining-hall
chickpea	pirouette
antiaging	whirligig
crime-scene	step-ladder
sarin	fille
dataflow	colorist
electability	twentyeight
wildland	blackleg
headphone	club-house
big-picture	pocket-knife
progestin	strumpet
slickrock	stove-pipe
eighth-grader	imperiousness
pro-independence	acquisitiveness
wonk	edu
falafel	aether
dpi	som
hegemon	tanager
megachurch	explication
keyboardist	half-an-hour
supernovas	corn-meal
sidecut	auricle
sashimi	tromba
tahini	singe
speciation	break-down
enabler	tympanum
high-capacity	prize-fighter
inkjet	culpa
interferometry	organ-grinder
misdiagnosis	county-seat
consumerist	mother-love
techie	doore
ototoxicity	coat-of-arms
micromanage	wintergreen
grommet	lurida
subsidiarity	pontificate
intercountry	co-existence
substance-abuse	supernaturalism
deal-making	deification
intranet	dolorosa
alkyd	borer
mouthwatering	squeamishness
spectrometry	infrequency
in-vitro	hegumen
biomedicine	persiflage
flyover	bowline
chakra	statics
oestrogen	cantonment
buttercream	harmlessness
breathability	mischief-maker
attendee	sequitur
orality	poopie
kbps	feu
newbie	potin
hacia	estab
whiteboard	millenium
kya	ris
dodgeball	saleratus
dotcom	didna
gluteus	peuple
batterer	lumbago
ingroup	savoir
high-growth	abolishment
encephalopathy	morning-glory
catch-and-release	unscrupulousness
hottie	ukase
cooktop	doxology
postdoc	bonheur
preservationist	self-direction
five-spice	fire-eater
private-label	trading-post
swingman	giantess
rotavirus	harpooneer
soba	mohel
ramen	cumin
favorability	materiality
all-sky	triste
alendronate	office-boy
e-business	proconsul
big-play	verbena
cyberpunk	litigant
ejido	tendin
phaser	bon-bon
kickball	allspice
nonresponse	morning-room
audiogram	beaucoup
surimi	nigra
lensing	brawler
cybersecurity	truth-telling
ronko	capo
dumbing	slopey
novela	dressin
serotype	soapstone
low-incidence	office-holder
scheduler	clansman
cook-off	desuetude
infill	houris
merengue	torturer
wavefront	dumbness
noncredit	erysipelas
point-and-shoot	fortune-telling
bodysuit	pow-wow
queso	ka-ka
quote-unquote	blood-letting
criminalist	slovenliness
fifth-grader	buccaneering
atrazine	apocrypha
bonobo	nobile
otolaryngologist	self-accusation
skybox	mortem
polyimide	poll-tax
bpg	tum
listserv	acerbity
cross-sex	violente
workflow	hen-house
waypoint	truckman
p-value	snogger
maquiladora	coffee-cup
