voice-over	development
video	henry
software	promise
gender	estate
e-mail	slave
teaspoon	testimony
infrastructure	entertainment
feedback	circuit
lifestyle	selection
youre	dean
metro	organ
database	historian
website	reproach
pasta	reign
tablespoon	threshold
update	revival
workplace	assumption
healthcare	philosopher
fax	core
workout	theology
regression	mathematics
parenting	accuracy
ethnicity	attraction
baseline	location
ecosystem	abolition
processor	sterling
ppg	kit
spokeswoman	preservation
icon	essay
globalization	classification
email	defect
governance	catalogue
interface	category
workforce	transition
laptop	mastery
biodiversity	individuality
info	medal
blog	choir
outreach	connexion
preschool	treatise
privatization	championship
overview	censure
watercolor	affliction
backpack	fairness
download	cluster
artwork	resource
hip-hop	hamlet
peacekeeping	partnership
salsa	canon
same-sex	livestock
multimedia	extinction
genome	option
predictor	attainment
autism	rivalry
sensor	sector
cilantro	accession
sustainability	neighbourhood
empowerment	specialist
condom	hedge
self-efficacy	reproduction
ethanol	rotation
anthrax	spectrum
tsunami	fervor
rehab	bias
filmmaker	arithmetic
subscale	trustee
def	ox
entitlement	commentary
tsp	polo
condo	photo
bailout	musician
groundwater	basketball
downside	classroom
landfill	proximity
algorithm	subsidiary
wastewater	metaphysics
spokesperson	jurisprudence
postseason	meditation
dysfunction	curriculum
sitcom	evasion
analog	album
tofu	sub
arousal	segment
ballpark	supporter
victimization	autobiography
backcountry	flexibility
offseason	schoolboy
burnout	magnet
biomass	builder
acculturation	surveillance
osteoporosis	contingency
start-up	pregnancy
fundraising	dedication
firefighter	competitor
homelessness	quartermaster
testosterone	collaboration
biotechnology	philanthropy
caregiver	container
browser	vineyard
nonstick	viewpoint
cornerback	waterfront
sunscreen	disability
biotech	terrain
cellphone	embodiment
soundtrack	neighbour
wellness	cruiser
cyberspace	precedence
makeover	township
app	cult
steroid	makeup
ponytail	orthodoxy
after-school	documentary
sushi	otter
oregano	settler
meltdown	residue
gridlock	infinity
template	backbone
worldview	birthplace
rapper	gully
fund-raiser	orientation
giftedness	referendum
multiculturalism	unconsciousness
pandemic	nickname
audiotape	pavilion
timeline	sponsor
handheld	induction
telecom	novice
epidemiology	quarterback
ultrasound	south-west
counterterrorism	differentiation
mpg	ski
self-report	availability
wake-up	catcher
marinade	cascade
matchup	radius
self-concept	disobedience
minivan	sycamore
hotline	recluse
aerobics	violinist
subset	chute
pretest	educator
vibe	mall
wetland	investor
sexism	trump
remediation	organisation
whos	terra
mindset	anthem
bandwidth	evangelist
vegan	knave
coauthor	gymnasium
antioxidant	disrespect
deforestation	generalization
mozzarella	indicator
pesto	booze
biosphere	textbook
entrepreneurship	experimentation
pts	pub
startup	epitaph
replication	culmination
prosthesis	anarchist
fundraiser	churchyard
chi-square	designation
postmodernism	insignificance
arugula	atheism
aquaculture	municipality
rainforest	bookseller
cardio	detour
mind-set	pedigree
percentile	subscriber
taxonomy	acclaim
trailhead	vanguard
dumpster	quartet
cyber	noir
caregiving	erudition
carcinoma	scepticism
ricotta	feeder
conceptualization	characterization
methamphetamine	anthropologist
payback	bracket
subgroup	baritone
facilitator	bibliography
daycare	stucco
dot-com	ailment
predation	mushroom
canola	flier
moisturizer	displacement
weight-loss	computation
coursework	creativity
spreadsheet	dissertation
midlife	travail
couscous	pantheon
nanotechnology	specification
homophobia	coordinator
inpatient	semester
pathogen	lawsuit
optimization	contributor
poetics	arcade
aka	viz
risotto	dolphin
functionality	nomenclature
epicenter	keyboard
finalist	fixture
dopamine	rancher
encryption	renovation
practicum	curvature
e-commerce	forefront
high-resolution	implementation
test-retest	compilation
subtest	activist
connector	pageantry
meta-analysis	ornamentation
lasagna	supplier
lambda	variant
pixel	modem
blogger	shingle
hyperactivity	receptionist
categorization	anti-semitism
neuroscience	infiltration
karaoke	pastry
steelhead	boyfriend
veggie	nylon
connectivity	juxtaposition
free-agent	mainstream
teacher-librarian	self-determination
camcorder	medication
self-worth	householder
deconstruction	sophistication
derailleur	portrayal
microprocessor	configuration
tinnitus	sawmill
jalapeno	striker
firestorm	girlfriend
marginalization	attractiveness
chemo	heyday
countertop	distributor
aquifer	tactic
workstation	electrician
no-fly	banjo
discriminant	perturbation
upfront	cuisine
detainee	falsity
lymphoma	paperback
superhero	backdrop
low-sodium	classmate
hypothermia	amalgamation
synergy	racism
no-brainer	trademark
airfare	folklore
forensics	relativity
subtext	bowler
kayaking	credence
apnea	pout
coworker	closure
largemouth	deployment
politicization	anti-aircraft
gamma-ray	parasite
stressor	primate
tomography	developer
pager	sans
oncology	populist
motivator	trillion
generalizability	conscientiousness
stakeholder	percussion
co-chair	virtuoso
firewall	increment
snowboard	stereotype
drywall	soccer
downtime	gradation
affordability	predilection
cappuccino	allegation
renewables	connivance
reinvention	battleground
childcare	obituary
texting	primacy
ultralight	limelight
moniker	format
pulsar	cello
antidepressant	impersonation
fine-tuning	consortium
wild-card	hometown
t-test	genre
latte	opus
salience	artistry
antivirus	thriller
drivetrain	orphanage
quadriceps	arthritis
genomics	antenna
chairperson	convocation
shallot	lineup
biodiesel	facsimile
self-assessment	stratification
radiotherapy	aide-de-camp
singer-songwriter	lieutenant-colonel
supermodel	rendition
malware	surname
oncologist	phosphate
bioethics	clarinet
melatonin	hepatitis
add-on	archery
skateboard	interplay
triathlon	pittance
chalkboard	instigation
playbook	obloquy
biota	femme
sobre	sniper
telemarketing	individualist
deep-sky	flatness
lube	spa
metadata	plenitude
baguette	leprosy
pro-democracy	mountainside
keyword	ecology
hydration	heartbreak
creationism	alternation
otitis	papyrus
tamoxifen	deathbed
nano	saber
cortisol	bedrock
ibuprofen	genealogy
self-evaluation	miscalculation
bulimia	petrol
transducer	harmonica
pedophile	blueprint
blogging	conduit
subsystem	adherent
reauthorization	internationalism
e-book	rugby
joystick	warship
postmodernist	equalization
eyeliner	etymology
ecclesiology	protagonist
cell-phone	old-timer
timeout	penguin
clubhead	summation
covariate	trombone
seafloor	interment
antibacterial	schizophrenia
tradeoff	boomerang
overfishing	nonfiction
osteoarthritis	documentation
spyware	anemia
miso	glut
personhood	footprint
covariance	stewardship
burrito	provider
anti-terrorism	commemoration
glam	canto
next-generation	liberalization
clubface	hallmark
bioterrorism	containment
cookware	excerpt
outage	xxxvi
bycatch	misnomer
redshirt	camphor
guacamole	chromium
bottom-up	follow-up
oxymoron	line-up
near-death	highlight
cellulite	genetics
ex-boyfriend	half-brother
ecotourism	eye-witness
cost-effectiveness	telecommunications
weightlifting	historiography
stem-cell	agnostic
speech-language	principalities
quinoa	sprawl
keypad	xxxix
self-care	paradigm
folate	bowel
narratology	luminosity
rollover	silicon
throughput	workhouse
ex-girlfriend	redevelopment
gangsta	passer
phyllo	airlift
homecare	butternut
telecommuting	cross-section
metastasis	combatant
liposuction	expatriate
hardcopy	attacker
bungee	advisor
partial-birth	sight-seeing
techno	trainee
fast-forward	fingerprint
jihadist	offshoot
underachievement	air-conditioning
conferencing	anachronism
detox	demo
collider	break-up
shoulder-width	inflexibility
biofeedback	simulation
chainsaw	heroics
worksheet	shutdown
acetaminophen	reunification
grunge	theorem
recyclables	seamanship
colonoscopy	cartoonist
shiitake	redness
halogen	runoff
otolaryngology	counterattack
concealer	amplifier
preschooler	confluence
co-anchor	lateness
open-source	inaccuracy
redshift	breakup
futon	yoga
phytoplankton	circumcision
byte	soy
pancetta	weekday
same-gender	half-sister
winemaker	exactitude
seatpost	gunnery
single-payer	frontiersman
breast-cancer	malnutrition
kinesiology	pharmacist
pre-test	jawbone
infomercial	outfielder
curveball	freshwater
low-carb	hydroxide
self-talk	monogram
lightbulb	pedagogue
midfielder	avant-garde
copycat	vizier
interrater	panegyric
signage	prefix
collegiality	broadcaster
hummus	homme
bed-and-breakfast	self-destruction
celeb	locus
desertification	responsiveness
smartphone	realisation
tempeh	feces
bulgur	kiosk
self-perception	misinformation
menorah	compiler
yellowfin	collation
exceptionalism	psychoanalyst
mimesis	resale
fossa	fluke
neuroscientist	impoverishment
marinara	prognosis
hijab	voodoo
goalkeeper	methodology
weeknight	inhalation
wormhole	monsoon
feedstock	airliner
longline	chimera
single-sex	prophetess
uptick	rabies
paralegal	airstrip
factorial	wrestler
headlamp	trilogy
aromatherapy	intermarriage
nonattainment	archaeologist
lycopene	rainstorm
off-the-shelf	collaborator
focuser	cleric
subsample	teenager
focalization	fornication
ethicist	footage
defibrillator	encyclopaedia
droid	slur
homeownership	improvisation
neoliberalism	impressionist
decaf	vita
germplasm	footwear
night-vision	menstruation
roadmap	coolie
returner	playoff
podcast	octave
rulemaking	torchlight
customization	expropriation
vez	pp
storyline	monarchist
primary-care	archdiocese
chorizo	guerilla
seatbelt	residency
pedicure	lexicon
transboundary	principality
homocysteine	linguistics
thirtysomething	instrumentation
mindfulness	linebacker
peptide	remake
printmaking	obstetrics
consultancy	geographer
singletrack	submachine
toolbar	goalie
wasabi	tenet
small-cap	humankind
interconnectedness	great-grandmother
e-books	stutter
midrange	statistic
hairstylist	choreography
rollout	cohort
low-intensity	idealization
mixed-use	firepower
motherboard	mainspring
search-and-rescue	rough-and-tumble
perfusion	poultice
takeaway	acoustics
radicchio	separatist
wideout	locale
contrarian	westbound
corporatist	morphology
out-of-wedlock	primogeniture
polypropylene	spiritualist
interactivity	interception
sunblock	stardom
low-dose	pseudonym
ergonomics	socialite
neurotransmitter	misinterpretation
lemongrass	adulthood
monofilament	enhancement
camo	coot
quartile	utensil
hyperinflation	compatibility
pretreatment	masturbation
tendinitis	disturber
desde	suffix
roadie	dervish
varimax	mandolin
multilateralism	acknowledgement
biofuel	sludge
webcam	nadir
contestation	pediatrician
seagrass	casserole
right-click	excitation
drawdown	jaundice
orienteering	shareholder
aftermarket	campaigner
cultivar	iteration
tilapia	sealer
skinhead	freelance
frontman	sprinter
at-bat	micro
bifida	entre
endometriosis	hypertension
fettuccine	ovulation
self-reflection	competitiveness
allele	toxin
hatchback	backlash
bodybuilding	accreditation
musics	troll
soft-tissue	woodworking
wiki	node
carpool	activism
ulama	alla
self-promotion	photosynthesis
winemaking	strongman
scallion	polarity
understory	maturation
whistle-blower	democratization
lutein	larch
cross-strait	determinant
hypertext	follicle
remix	logo
misperception	biochemistry
fibromyalgia	illustrator
arrhythmia	runner-up
handover	sulfate
nurturance	thrombosis
paraprofessional	professionalism
pop-culture	space-time
inbox	abacus
shareware	titanium
reboot	venue
workspace	co-author
lithium-ion	five-story
fatwa	xlix
workfare	hangout
dial-up	corncob
mascarpone	internship
voicemail	innovator
bruschetta	bluegrass
non-district	interpolation
windsurfing	recitative
burqa	acta
light-rail	semantics
all-wheel	glossary
student-teacher	predestination
adobo	rotor
chiasmus	handball
nachos	vinyl
endoscopy	logician
dataset	vagina
polymerase	bishopric
three-person	contravention
high-efficiency	disenchantment
fossil-fuel	meningitis
telenovelas	parallelism
beta-carotene	secretaryship
poststructuralist	contradistinction
intercorrelations	re-establishment
large-cap	solstice
usability	inversion
playlist	headset
live-action	collarbone
comorbidity	calculator
blogosphere	germination
jelly-roll	depiction
reconfiguration	transplantation
prion	hadn
koi	ka
geoengineering	profitability
timeframe	superstar
frizz	karma
megawatt	fatness
bioengineering	breast-pocket
synch	acne
carjacking	viability
protease	echelon
pecorino	antigen
snowpack	estrogen
jaw-dropping	legalization
off-trail	volleyball
commodification	great-grandson
off-label	architrave
teriyaki	sucrose
bridewealth	formaldehyde
student-athlete	persuasiveness
poblano	cooker
bluefin	libido
gelato	lineman
hip-width	ex-officio
post-apartheid	choreographer
speakerphone	middleweight
conjunto	cantata
headscarf	lacrosse
on-task	analogue
energy-efficiency	internationalist
biopic	rower
essentialist	condominium
sleepover	prefecture
chairlift	compressor
self-attention	parallelogram
intertextuality	fundamentalism
emirate	quintet
avoidant	ringside
miscommunication	self-abnegation
ciprofloxacin	abbreviation
carpal	scorer
head-to-toe	bookmaking
fascia	hiatus
toolkit	mix-up
blackgum	liquidity
two-factor	sobriquet
creatinine	shakedown
profiler	frontage
hunter-gatherer	intelligibility
self-disclosure	circumlocution
zero-tolerance	reaffirmation
bowhunting	pesticide
impulsivity	borderland
sociopath	evangelism
brulee	barrio
obra	cit
fictionality	chemotherapy
acidification	interlocutor
stormwater	songwriter
hoisin	chevron
metacognition	mistreatment
touch-screen	bloodstream
confit	praetor
nanosecond	evocation
special-education	collectivization
twentysomething	science-fiction
contextualization	non-intervention
sunroof	sundial
hoodie	intro
conflation	steepness
powertrain	biochemist
gentamicin	grassland
bodybuilder	subcontinent
rebar	quad
videoconferencing	foreign-exchange
duvet	agua
victimhood	reformist
cada	porn
ischemia	campsite
globalism	pellagra
sockeye	godson
photovoltaics	high-frequency
eutrophication	accessibility
low-maintenance	neutralization
interleague	love-story
counter-terrorism	self-incrimination
estaba	server
soymilk	abalone
narrativity	unevenness
layperson	deletion
hagfish	cassava
wakeup	cornea
buy-in	lesion
neuropathy	guitarist
graywater	basswood
drop-offs	tailings
snowboarder	gynecologist
crankset	feminism
airbag	inlay
reticle	reissue
telomerase	multiplier
bronzer	slider
interobserver	unsteadiness
cogeneration	hypothalamus
surrogacy	omelette
personalisation	ineffectiveness
oil-for-food	cheerleader
flatbread	genocide
birthweight	powerhouse
mentorship	intercity
hantavirus	trickster
turn-on	cadmium
porcini	fencer
representativeness	self-righteousness
narratee	tenancy
intubation	watermark
trick-or-treating	disqualification
faceup	basso
voice-mail	billionaire
ultrasonography	phosphorescence
antiterrorism	conductivity
screener	vocalist
cholesteatoma	counterfeiter
suppl	mana
kickboxing	take-over
airstrike	quotient
co-president	calligraphy
dysphagia	log-cabin
knockoff	android
videogame	blacklist
resveratrol	dissonance
telemarketer	step-father
linearity	etcetera
polycarbonate	rejuvenation
tonsillar	robustness
drow	pars
subtype	mascot
climate-change	meteorologist
biofilter	softball
antilock	tapioca
inculturation	re-education
sportfishing	coefficient
otorrhea	hectare
all-mountain	inculcation
post-independence	disfranchisement
superstore	nationale
single-case	speciality
role-play	freestone
hotspot	niacin
transnationalism	editor-in-chief
sonogram	cosmogony
biometrics	do-nothing
consultee	rainwater
exoskeleton	infertility
high-dose	selenium
saucepot	samurai
subcategory	acupuncture
opposite-sex	acceptability
controllability	special-interest
positivity	cognition
goodness-of-fit	intentionality
creationist	filtration
backstory	artifact
biocontrol	bridgehead
descriptor	badminton
leachate	reprise
ppb	ani
digitization	separateness
underrepresentation	internationalization
weight-bearing	falsification
eigenvalue	indenture
encoder	methyl
leptin	cleat
masala	betel
springform	videotape
broad-spectrum	anti-communism
self-presentation	unreasonableness
stockpot	acetone
low-fare	tremolo
dysplasia	music-hall
waveform	microfilm
impactor	sibling
belowground	welterweight
double-click	semiconductor
nonconference	immunization
off-task	demigod
lifecycle	ecliptic
self-selection	argumentation
astrophotography	mass-production
nematode	mitzvah
randomisation	steeplechase
qubit	biped
stepdad	header
flyfishing	eclecticism
self-referencing	conventionalism
peer-to-peer	conjugation
quintile	tutorial
cross-training	triangulation
identifier	coffeehouse
dorsiflexion	screenwriter
chickpea	scrotum
antiaging	imposter
crime-scene	suzerainty
sarin	pogo
multicollinearity	authoritarianism
dataflow	telephony
electability	cobblestone
wildland	cirrhosis
headphone	newscast
big-picture	narrow-gauge
progestin	sidekick
telework	tramway
slickrock	euthanasia
crostini	kickoff
touchscreen	suffragist
eighth-grader	self-portrait
microfiber	ionosphere
demonization	right-of-way
test-taking	devolution
pro-independence	parliamentarian
wonk	coli
oxytocin	warlord
falafel	welder
minicamp	gymnast
teleconference	interconnection
multiday	cyclist
audiometry	decathlon
whistleblower	reforestation
dpi	ru
frontcourt	self-rule
anaphylaxis	shibboleth
hegemon	acanthus
megachurch	saltwater
keyboardist	centrifuge
supernovas	bacterium
sidecut	torque
prioritization	profit-making
essentialism	ornithology
sashimi	launcher
backspin	halftime
co-creator	ex-husband
tahini	lupus
speciation	fratricide
enabler	sophist
high-capacity	cohabitation
inkjet	fjord
interferometry	common-school
misdiagnosis	decapitation
paediatrician	subjectivity
consumerist	weatherman
bioremediation	counter-attack
gamefish	placebo
overrepresentation	counterintelligence
techie	zombie
eyewear	mousse
legroom	gneiss
enhancer	sclerosis
ototoxicity	hydrocarbon
micromanage	coat-of-arms
grommet	vector
swimwear	anti-tank
undergrad	toxicity
franchisee	ballistics
freeride	entropy
subsidiarity	irradiation
intercountry	localization
substance-abuse	foreign-language
virtual-reality	submissiveness
strength-training	counter-revolution
deal-making	conduction
self-governance	thermodynamics
intranet	crossfire
alkyd	scam
mouthwatering	epistemology
spectrometry	nitroglycerin
in-vitro	receptor
biomedicine	mid-summer
anti-immigration	confidentiality
flyover	shootout
work-life	repeater
home-schooling	ill-treatment
taskbar	plenum
illuminance	outpatient
distractibility	conglomeration
hematoma	pontoon
firmware	yeshiva
prescription-drug	director-general
chakra	recon
information-processing	great-great-grandfather
oestrogen	city-state
business-to-business	balance-of-payments
buttercream	newscaster
breathability	country-seat
attendee	refresher
freefall	ambience
orality	civics
nanotube	gunpoint
kbps	tuba
newbie	latex
carnitine	excision
acupuncturist	codification
postmodernity	heterogeneity
hacia	spoof
microfinance	syndication
methylmercury	assertiveness
whiteboard	bandleader
kya	km
dodgeball	lyricism
time-series	monotheism
metafiction	flood-tide
rent-seeking	irrelevancy
noncontact	caliphate
co-writer	ubiquity
codependency	rationalist
homeschooling	directorship
dotcom	carat
falciparum	non-fiction
gluteus	peuple
sarcoidosis	co-ordinator
batterer	puddler
halfpipe	houseboy
ingroup	biopsy
high-growth	mid-november
survivalist	headphones
encephalopathy	insensitivity
catch-and-release	transubstantiation
hottie	in-law
cooktop	clothier
post-treatment	expressionism
postdoc	poolhall
audiation	referral
triglyceride	pontificate
skateboarder	planetarium
tapenade	back-up
preservationist	non-aggression
five-spice	readership
private-label	non-combatant
swingman	matchbox
end-user	insulator
fuelwood	novella
rotavirus	programmer
tallgrass	breather
soba	anus
ramen	hype
favorability	constructor
neurobiology	lexicographer
all-sky	triste
industrial-strength	great-grandchildren
alendronate	pediatrics
e-business	nationhood
big-play	colitis
switchgrass	handlebars
randomization	mountaineering
cyberpunk	robotics
ejido	situ
phaser	creche
kickball	zinnias
nonresponse	serviceman
audiogram	academia
surimi	bonsai
lensing	obverse
early-onset	confection
cybersecurity	propitiation
ronko	capo
dumbing	vanadium
novela	boron
serotype	lignite
low-incidence	legitimation
scheduler	consulship
cook-off	acronym
infill	sternum
merengue	dilation
wavefront	torturer
noncredit	ligament
point-and-shoot	self-absorption
bodysuit	masseur
queso	zeta
quote-unquote	permeability
criminalist	by-election
run-and-shoot	thundercloud
fifth-grader	blockbuster
quick-release	paleontology
atrazine	ontology
bonobo	ocher
otolaryngologist	over-production
skybox	rerum
polyimide	freestyle
all-wheel-drive	horticulturist
bpg	coda
meaning-making	ornithologist
listserv	caffeine
cross-sex	hydroxyl
workflow	seawater
triathlete	bestiality
anti-terror	four-wheel
waypoint	red-eye
reader-response	circumnavigation
p-value	comitia
micromanagement	secularization
maquiladora	reinsurance
